6 12
|----------|
|...|..--..|
|..-|..@...|
|......--..|
|--........|
|----------|