6 16
|--------------|
|FP.|......|...|
|......|....F..|
|.....@|...|...|
|P.F...|...P...|
|--------------|